. . . . . . . S0 . . . . .
. . . . . . . .  . . . . .
. . . . . . . .  . . . . .
. . . . . . . .  . . . . .
. . . . . . . .  . . . . .
. . . . . . . .  . . G . .
. . . . . . . .  . . . . .
. . . . . . . .  . . . . .
. . . . . . . .  . . . . .
. . . . . . . .  . . . . .
. . . . . . . X  . . . . .
. . . . . . . .  . . . . .