. . . . . . S1 S0 . . . . .
. . . . . . .  .  . . . . .
. . . . . . .  .  . . . . .
. . . . . . .  .  . . . . .
. . . . . . .  .  . . . . .
. . . . . . .  .  . . G . .
. . . . . . .  .  . . . . .
. . . . . . .  .  . . . . .
. . . . . . .  .  . . . . .
. . . . . . .  .  . . . . .
. . . . . . X  X  . . . . .
. . . . . . .  .  . . . . .