G . L2S . S0 S1 S2 S3  . . . . .
. .  .   . .  .  .  .  . . . . .
. .  .   . .  .  .  .  . . . . .  
@ @  .   . .  .  .  .  . . . . .  
. .  .   . .  .  .  @  @ @ @ @ @  
. .  .   . .  .  .  .  . . . . .  
. .  .   . .  .  .  .  . . . . L1W
. .  .   . .  .  .  @  G . . . .  
. G  .   . .  .  .  @  @ @ @ @ @  
. .  .   . .  .  .  .  . . . . .  
. .  .   . .  .  .  .  . X X . .  
. .  .   . G  .  .  .  . X X . G  