@ @ L0S @  @
@ .  .  .  @
@ F L1W S0 @
@ .  .  .  @
@ @  @  @  @
