@ @ L0S @  @
@ .  .  G  @
@ X  .  S0 @
@ X  .  S1 @
@ @  @  @  @
