@ @ L0S @  @
@ .  .  .  @
@ F  V  S0 @
@ .  .  .  @
@ @  @  @  @
