@ @ L0S @  @
@ .  .  .  @
@ X  G  S0 @
@ .  .  .  @
@ @  @  @  @
