@ @ L0S @  @
@ .  .  .  @
@ X  .  S0 @
@ X  .  S1 @
@ @  @  @  @
