@ @ L0S @  @
@ .  .  .  @
@ F  .  S1 @
@ F  .  S0 @
@ @  @  @  @
