@ @ L0S @  @
@ .  .  .  @
@ X  .  S1 @
@ X  .  S0 @
@ @  @  @  @
