@ @ L0S @  @
@ .  .  .  @
@ F  G  S0 @
@ .  .  .  @
@ @  @  @  @
