@ @ L0S @  @
@ .  .  G  @
@ F  .  S0 @
@ F  .  S1 @
@ @  @  @  @
