@ @ L0S @  @
@ .  .  .  @
@ X L1W S0 @
@ .  .  .  @
@ @  @  @  @
