@ @ L0S @  @
@ .  .  .  @
@ F  .  S0 @
@ .  .  .  @
@ @  .  @  @
