@ @ L0S @  @
@ .  .  .  @
@ X  .  S0 @
@ .  .  .  @
@ @  .  @  @
