@ @ L0S @  @
@ .  .  .  @
@ X  V  S0 @
@ .  .  .  @
@ @  @  @  @
