@ @ @  @ @ @
@ . .  . . @
@ . S0 . . @
@ . .  F . @
@ @ @  @ @ @