@ @ @  @ @ @
@ . .  . . @
@ . S0 . . @
@ . .  X . @
@ @ @  @ @ @