@ @ L0S @  @
@ F  .  S0 @
@ .  .  .  @
@ F  .  S1 @
@ @ L1N  @ @
