. . . . . . . S0 . . . . .
. . . . . . . .  . . . . .
. . . . . . . .  . . . . .
. . . . . . . .  . . . . .
. . . . . . . .  . . . . .
. . . . . . . .  . . G . .
. . . . . . . .  . . . . .
. . . . . . . .  . . . . .
. . . . . . . .  . . . . .
. . . . . . . .  . . . . .
. . . . . . . F  . . . . .
. . . . . . . .  . . . . .