. . . . . . S1 S0 . . . . .
. . . . . . .  .  . . . . .
. . . . . . .  .  . . . . .
. . . . . . .  .  . . . . .
. . . . . . .  .  . . . . .
. . . . . . .  .  . . G . .
. . . . . . .  .  . . . . .
. . . . . . .  .  . . . . .
. . . . . . .  .  . . . . .
. . . . . . .  .  . . . . .
. . . . . . F  F  . . . . .
. . . . . . .  .  . . . . .