  .  . . . . . . S0 S1 . . . .
  .  . . . . . . .  .  . . . .
  .  . . . . . . .  .  . . . .
  .  . . . . . . .  .  . . . .
 L0E . . . . . . .  .  . . . .
  .  . . . . . . .  .  . G . .
  .  . . . . . . .  .  . . . .
  .  . . . . . . .  .  . . . .
  .  . . . . . . .  .  . . . .
  .  . . . . . . .  .  . . . .
  .  . . . . . . F  F  . . . .
  .  . . . . . . .  .  . . . .