G . L2S . S0 S1 S2 S3  . . . . .
. .  .   . .  .  .  .  . . . . .
. .  .   . .  .  .  .  . . . . .  
@ @  .   . .  .  .  .  . . . . .  
. .  .   . .  .  .  @  @ @ @ @ @  
. .  .   . .  .  .  .  . . . . .  
. .  .   . .  .  .  .  . . . . ~L1W
. .  .   . .  .  .  @  G . . . .  
. G  .   . .  .  .  @  @ @ @ @ @  
. .  .   . .  .  .  .  . . . . .  
. .  .   . .  .  .  .  . F F . .  
. .  .   . G  .  .  .  . F F . G  