  .   G  @ . . . S0 .  .  .  S3 . . 
  .   @  . . . . .  .  .  .  .  . .   
  .  L2S . . . . .  .  .  .  .  . .   
  .   .  . . . . .  .  .  .  .  . .   
  @   @  . . . . S2 .  .  .  S1 . .   
 L0E  .  . . . . .  .  .  .  .  . .   
  @   .  @ @ @ @ @  @  .  .  .  . .
  G   .  . . @ . .  .  .  .  .  . @   
  @   @  @ . @ . . L1S @  @  @  @ G   
  .   .  . . @ . .  .  .  .  .  . .   
  .   X  X . . . .  .  . L3S @  @ .   
  .   X  X . . . .  .  .  .  G  . .   
